Bulbasaur	Grass	Poison
Ivysaur	Grass	Poison
Venusaur	Grass	Poison
Charmander	Fire	none
Charmeleon	Fire	none
Charizard	Fire	Flying
Squirtle	Water	none
Wartortle	Water	none
Blastoise	Water	none
Caterpie	Bug	none
Metapod	Bug	none
Butterfree	Bug	Flying
Weedle	Bug	Poison
Kakuna	Bug	Poison
Beedrill	Bug	Poison
Pidgey	Normal	Flying
Pidgeotto	Normal	Flying
Pidgeot	Normal	Flying
Rattata	Normal	none
Raticate	Normal	none
Spearow	Normal	Flying
Fearow	Normal	Flying
Ekans	Poison	none
Arbok	Poison	none
Pikachu	Electric	none
Raichu	Electric	none
Sandshrew	Ground	none
Sandslash	Ground	none
NidoranF	Poison	none
Nidorina	Poison	none
Nidoqueen	Poison	Ground
NidoranM	Poison	none
Nidorino	Poison	none
Nidoking	Poison	Ground
Clefairy	Fairy	none
Clefable	Fairy	none
Vulpix	Fire	none
Ninetales	Fire	none
Jigglypuff	Normal	Fairy
Wigglytuff	Normal	Fairy
Zubat	Poison	Flying
Golbat	Poison	Flying
Oddish	Grass	Poison
Gloom	Grass	Poison
Vileplume	Grass	Poison
Paras	Bug	Grass
Parasect	Bug	Grass
Venonat	Bug	Poison
Venomoth	Bug	Poison
Diglett	Ground	none
Dugtrio	Ground	none
Meowth	Normal	none
Persian	Normal	none
Psyduck	Water	none
Golduck	Water	none
Mankey	Fighting	none
Primeape	Fighting	none
Growlithe	Fire	none
Arcanine	Fire	none
Poliwag	Water	none
Poliwhirl	Water	none
Poliwrath	Water	Fighting
Abra	Psychic	none
Kadabra	Psychic	none
Alakazam	Psychic	none
Machop	Fighting	none
Machoke	Fighting	none
Machamp	Fighting	none
Bellsprout	Grass	Poison
Weepinbell	Grass	Poison
Victreebel	Grass	Poison
Tentacool	Water	Poison
Tentacruel	Water	Poison
Geodude	Rock	Ground
Graveler	Rock	Ground
Golem	Rock	Ground
Ponyta	Fire	none
Rapidash	Fire	none
Slowpoke	Water	Psychic
Slowbro	Water	Psychic
Magnemite	Electric	Steel
Magneton	Electric	Steel
Farfetch'd	Normal	Flying
Doduo	Normal	Flying
Dodrio	Normal	Flying
Seel	Water	none
Dewgong	Water	Ice
Grimer	Poison
Muk	Poison	none
Shellder	Water
Cloyster	Water	Ice
Gastly	Ghost	Poison
Haunter	Ghost	Poison
Gengar	Ghost	Poison
Onix	Rock	Ground
Drowzee	Psychic	none
Hypno	Psychic	none
Krabby	Water	none
Kingler	Water	none
Voltorb	Electric	none
Electrode	Electric	none
Exeggcute	Grass	Psychic
Exeggutor	Grass	Psychic
Cubone	Ground	none
Marowak	Ground	none
Hitmonlee	Fighting	none
Hitmonchan	Fighting	none
Lickitung	Normal	none
Koffing	Poison	none
Weezing	Poison	none
Rhyhorn	Ground	Rock
Rhydon	Ground	Rock
Chansey	Normal	none
Tangela	Grass	none
Kangaskhan	Normal	none
Horsea	Water	none
Seadra	Water	none
Goldeen	Water	none
Seaking	Water	none
Staryu	Water	none
Starmie	Water	Psychic
Mr. Mime	Psychic	Fairy
Scyther	Bug	Flying
Jynx	Ice	Psychic
Electabuzz	Electric	none
Magmar	Fire	none
Pinsir	Bug	none
Tauros	Normal	none
Magikarp	Water	none
Gyarados	Water	Flying
Lapras	Water	Ice
Ditto	Normal	none
Eevee	Normal	none
Vaporeon	Water	none
Jolteon	Electric	none
Flareon	Fire	none
Porygon	Normal	none
Omanyte	Rock	Water
Omastar	Rock	Water
Kabuto	Rock	Water
Kabutops	Rock	Water
Aerodactyl	Rock	Flying
Snorlax	Normal	none
Articuno	Ice	Flying
Zapdos	Electric	Flying
Moltres	Fire	Flying
Dratini	Dragon	none
Dragonair	Dragon	none
Dragonite	Dragon	Flying
Mewtwo	Psychic	none
Mew	Psychic	none
Chikorita	Grass	none
Bayleef	Grass	none
Meganium	Grass	none
Cyndaquil	Fire	none
Quilava	Fire	none
Typhlosion	Fire	none
Totodile	Water	none
Croconaw	Water	none
Feraligatr	Water	none
Sentret	Normal	none
Furret	Normal	none
Hoothoot	Normal	Flying
Noctowl	Normal	Flying
Ledyba	Bug	Flying
Ledian	Bug	Flying
Spinarak	Bug	Poison
Ariados	Bug	Poison
Crobat	Poison	Flying
Chinchou	Water	Electric
Lanturn	Water	Electric
Pichu	Electric	none
Cleffa	Fairy	none
Igglybuff	Normal	Fairy
Togepi	Fairy	none
Togetic	Fairy	Flying
Natu	Psychic	Flying
Xatu	Psychic	Flying
Mareep	Electric	none
Flaaffy	Electric	none
Ampharos	Electric	none
Bellossom	Grass	none
Marill	Water	Fairy
Azumarill	Water	Fairy
Sudowoodo	Rock	none
Politoed	Water	none
Hoppip	Grass	Flying
Skiploom	Grass	Flying
Jumpluff	Grass	Flying
Aipom	Normal	none
Sunkern	Grass	none
Sunflora	Grass	none
Yanma	Bug	Flying
Wooper	Water	Ground
Quagsire	Water	Ground
Espeon	Psychic	none
Umbreon	Dark	none
Murkrow	Dark	Flying
Slowking	Water	Psychic
Misdreavus	Ghost	none
Unown	Psychic	none
Wobbuffet	Psychic	none
Girafarig	Normal	Psychic
Pineco	Bug	none
Forretress	Bug	Steel
Dunsparce	Normal	none
Gligar	Ground	Flying
Steelix	Steel	Ground
Snubbull	Fairy	none
Granbull	Fairy	none
Qwilfish	Water	Poison
Scizor	Bug	Steel
Shuckle	Bug	Rock
Heracross	Bug	Fighting
Sneasel	Dark	Ice
Teddiursa	Normal	none
Ursaring	Normal	none
Slugma	Fire	none
Magcargo	Fire	Rock
Swinub	Ice	Ground
Piloswine	Ice	Ground
Corsola	Water	Rock
Remoraid	Water	none
Octillery	Water	none
Delibird	Ice	Flying
Mantine	Water	Flying
Skarmory	Steel	Flying
Houndour	Dark	Fire
Houndoom	Dark	Fire
Kingdra	Water	Dragon
Phanpy	Ground	none
Donphan	Ground	none
Porygon2	Normal	none
Stantler	Normal	none
Smeargle	Normal	none
Tyrogue	Fighting	none
Hitmontop	Fighting	none
Smoochum	Ice	Psychic
Elekid	Electric	none
Magby	Fire	none
Miltank	Normal	none
Blissey	Normal	none
Raikou	Electric	none
Entei	Fire	none
Suicune	Water	none
Larvitar	Rock	Ground
Pupitar	Rock	Ground
Tyranitar	Rock	Dark
Lugia	Psychic	Flying
Ho-Oh	Fire	Flying
Celebi	Psychic	Grass
Treecko	Grass
Grovyle	Grass
Sceptile	Grass
Torchic	Fire
Combusken	Fire	Fighting
Blaziken	Fire	Fighting
Mudkip	Water
Marshtomp	Water	Ground
Swampert	Water	Ground
Poochyena	Dark	none
Mightyena	Dark	none
Zigzagoon	Normal	none
Linoone	Normal	none
Wurmple	Bug	none
Silcoon	Bug	none
Beautifly	Bug	Flying
Cascoon	Bug	none
Dustox	Bug	Poison
Lotad	Water	Grass
Lombre	Water	Grass
Ludicolo	Water	Grass
Seedot	Grass	none
Nuzleaf	Grass	Dark
Shiftry	Grass	Dark
Taillow	Normal	Flying
Swellow	Normal	Flying
Wingull	Water	Flying
Pelipper	Water	Flying
Ralts	Psychic	Fairy
Kirlia	Psychic	Fairy
Gardevoir	Psychic	Fairy
Surskit	Bug	Water
Masquerain	Bug	Flying
Shroomish	Grass	none
Breloom	Grass	Fighting
Slakoth	Normal	none
Vigoroth	Normal	none
Slaking	Normal	none
Nincada	Bug	Ground
Ninjask	Bug	Flying
Shedinja	Bug	Ghost
Whismur	Normal	none
Loudred	Normal	none
Exploud	Normal	none
Makuhita	Fighting	none
Hariyama	Fighting	none
Azurill	Normal	Fairy
Nosepass	Rock	none
Skitty	Normal	none
Delcatty	Normal	none
Sableye	Dark	Ghost
Mawile	Steel	Fairy
Aron	Steel	Rock
Lairon	Steel	Rock
Aggron	Steel	Rock
Meditite	Fighting	Psychic
Medicham	Fighting	Psychic
Electrike	Electric	none
Manectric	Electric	none
Plusle	Electric	none
Minun	Electric	none
Volbeat	Bug	none
Illumise	Bug	none
Roselia	Grass	Poison
Gulpin	Poison	none
Swalot	Poison	none
Carvanha	Water	Dark
Sharpedo	Water	Dark
Wailmer	Water	none
Wailord	Water	none
Numel	Fire	Ground
Camerupt	Fire	Ground
Torkoal	Fire	none
Spoink	Psychic	none
Grumpig	Psychic	none
Spinda	Normal	none
Trapinch	Ground	none
Vibrava	Ground	Dragon
Flygon	Ground	Dragon
Cacnea	Grass	none
Cacturne	Grass	Dark
Swablu	Normal	Flying
Altaria	Dragon	Flying
Zangoose	Normal	none
Seviper	Poison	none
Lunatone	Rock	Psychic
Solrock	Rock	Psychic
Barboach	Water	Ground
Whiscash	Water	Ground
Corphish	Water	none
Crawdaunt	Water	Dark
Baltoy	Ground	Psychic
Claydol	Ground	Psychic
Lileep	Rock	Grass
Cradily	Rock	Grass
Anorith	Rock	Bug
Armaldo	Rock	Bug
Feebas	Water	none
Milotic	Water	none
Castform	Normal	none
Kecleon	Normal	none
Shuppet	Ghost	none
Banette	Ghost	none
Duskull	Ghost	none
Dusclops	Ghost	none
Tropius	Grass	Flying
Chimecho	Psychic	none
Absol	Dark	none
Wynaut	Psychic	none
Snorunt	Ice	none
Glalie	Ice	none
Spheal	Ice	Water
Sealeo	Ice	Water
Walrein	Ice	Water
Clamperl	Water	none
Huntail	Water	none
Gorebyss	Water	none
Relicanth	Water	Rock
Luvdisc	Water	none
Bagon	Dragon	none
Shelgon	Dragon	none
Salamence	Dragon	Flying
Beldum	Steel	Psychic
Metang	Steel	Psychic
Metagross	Steel	Psychic
Regirock	Rock	none
Regice	Ice	none
Registeel	Steel	none
Latias	Dragon	Psychic
Latios	Dragon	Psychic
Kyogre	Water	none
Groudon	Ground	none
Rayquaza	Dragon	Flying
Jirachi	Steel	Psychic
Deoxys	Psychic	none
Turtwig	Grass	none
Grotle	Grass	none
Torterra	Grass	Ground
Chimchar	Fire	none
Monferno	Fire	Fighting
Infernape	Fire	Fighting
Piplup	Water	none
Prinplup	Water	none
Empoleon	Water	Steel
Starly	Normal	Flying
Staravia	Normal	Flying
Staraptor	Normal	Flying
Bidoof	Normal	none
Bibarel	Normal	Water
Kricketot	Bug	none
Kricketune	Bug	none
Shinx	Electric	none
Luxio	Electric	none
Luxray	Electric	none
Budew	Grass	Poison
Roserade	Grass	Poison
Cranidos	Rock	none
Rampardos	Rock	none
Shieldon	Rock	Steel
Bastiodon	Rock	Steel
Burmy	Bug	none
Wormadam	Bug	Grass
Mothim	Bug	Flying
Combee	Bug	Flying
Vespiquen	Bug	Flying
Pachirisu	Electric	none
Buizel	Water	none
Floatzel	Water	none
Cherubi	Grass	none
Cherrim	Grass	none
Shellos	Water	none
Gastrodon	Water	Ground
Ambipom	Normal	none
Drifloon	Ghost	Flying
Drifblim	Ghost	Flying
Buneary	Normal	none
Lopunny	Normal	none
Mismagius	Ghost	none
Honchkrow	Dark	Flying
Glameow	Normal	none
Purugly	Normal	none
Chingling	Psychic	none
Stunky	Poison	Dark
Skuntank	Poison	Dark
Bronzor	Steel	Psychic
Bronzong	Steel	Psychic
Bonsly	Rock	none
Mime Jr.	Psychic	Fairy
Happiny	Normal	none
Chatot	Normal	Flying
Spiritomb	Ghost	Dark
Gible	Dragon	Ground
Gabite	Dragon	Ground
Garchomp	Dragon	Ground
Munchlax	Normal	none
Riolu	Fighting	none
Lucario	Fighting	Steel
Hippopotas	Ground	none
Hippowdon	Ground	none
Skorupi	Poison	Bug
Drapion	Poison	Dark
Croagunk	Poison	Fighting
Toxicroak	Poison	Fighting
Carnivine	Grass	none
Finneon	Water	none
Lumineon	Water	none
Mantyke	Water	Flying
Snover	Grass	Ice
Abomasnow	Grass	Ice
Weavile	Dark	Ice
Magnezone	Electric	Steel
Lickilicky	Normal	none
Rhyperior	Ground	Rock
Tangrowth	Grass	none
Electivire	Electric	none
Magmortar	Fire	none
Togekiss	Fairy	Flying
Yanmega	Bug	Flying
Leafeon	Grass	none
Glaceon	Ice	none
Gliscor	Ground	Flying
Mamoswine	Ice	Ground
Z	Porygon-Z	Normal
Gallade	Psychic	Fighting
Probopass	Rock	Steel
Dusknoir	Ghost	none
Froslass	Ice	Ghost
Rotom	Electric	Ghost
Uxie	Psychic	none
Mesprit	Psychic	none
Azelf	Psychic	none
Dialga	Steel	Dragon
Palkia	Water	Dragon
Heatran	Fire	Steel
Regigigas	Normal	none
Giratina	Ghost	Dragon
Cresselia	Psychic	none
Phione	Water	none
Manaphy	Water	none
Darkrai	Dark	none
Shaymin	Grass	none
Arceus	Normal	none
Victini	Psychic	Fire
Snivy	Grass	none
Servine	Grass	none
Serperior	Grass	none
Tepig	Fire	none
Pignite	Fire	Fighting
Emboar	Fire	Fighting
Oshawott	Water	none
Dewott	Water	none
Samurott	Water	none
Patrat	Normal	none
Watchog	Normal	none
Lillipup	Normal	none
Herdier	Normal	none
Stoutland	Normal	none
Purrloin	Dark	none
Liepard	Dark	none
Pansage	Grass	none
Simisage	Grass	none
Pansear	Fire	none
Simisear	Fire	none
Panpour	Water	none
Simipour	Water	none
Munna	Psychic	none
Musharna	Psychic	none
Pidove	Normal	Flying
Tranquill	Normal	Flying
Unfezant	Normal	Flying
Blitzle	Electric	none
Zebstrika	Electric	none
Roggenrola	Rock	none
Boldore	Rock	none
Gigalith	Rock	none
Woobat	Psychic	Flying
Swoobat	Psychic	Flying
Drilbur	Ground	none
Excadrill	Ground	Steel
Audino	Normal	none
Timburr	Fighting	none
Gurdurr	Fighting	none
Conkeldurr	Fighting	none
Tympole	Water	none
Palpitoad	Water	Ground
Seismitoad	Water	Ground
Throh	Fighting	none
Sawk	Fighting	none
Sewaddle	Bug	Grass
Swadloon	Bug	Grass
Leavanny	Bug	Grass
Venipede	Bug	Poison
Whirlipede	Bug	Poison
Scolipede	Bug	Poison
Cottonee	Grass	Fairy
Whimsicott	Grass	Fairy
Petilil	Grass	none
Lilligant	Grass	none
Basculin	Water	none
Sandile	Ground	Dark
Krokorok	Ground	Dark
Krookodile	Ground	Dark
Darumaka	Fire	none
Darmanitan	Fire	none
Maractus	Grass	none
Dwebble	Bug	Rock
Crustle	Bug	Rock
Scraggy	Dark	Fighting
Scrafty	Dark	Fighting
Sigilyph	Psychic	Flying
Yamask	Ghost	none
Cofagrigus	Ghost	none
Tirtouga	Water	Rock
Carracosta	Water	Rock
Archen	Rock	Flying
Archeops	Rock	Flying
Trubbish	Poison	none
Garbodor	Poison	none
Zorua	Dark	none
Zoroark	Dark	none
Minccino	Normal	none
Cinccino	Normal	none
Gothita	Psychic	none
Gothorita	Psychic	none
Gothitelle	Psychic	none
Solosis	Psychic	none
Duosion	Psychic	none
Reuniclus	Psychic	none
Ducklett	Water	Flying
Swanna	Water	Flying
Vanillite	Ice	none
Vanillish	Ice	none
Vanilluxe	Ice	none
Deerling	Normal	Grass
Sawsbuck	Normal	Grass
Emolga	Electric	Flying
Karrablast	Bug	none
Escavalier	Bug	Steel
Foongus	Grass	Poison
Amoonguss	Grass	Poison
Frillish	Water	Ghost
Jellicent	Water	Ghost
Alomomola	Water
Joltik	Bug	Electric
Galvantula	Bug	Electric
Ferroseed	Grass	Steel
Ferrothorn	Grass	Steel
Klink	Steel	none
Klang	Steel	none
Klinklang	Steel	none
Tynamo	Electric	none
Eelektrik	Electric	none
Eelektross	Electric	none
Elgyem	Psychic	none
Beheeyem	Psychic	none
Litwick	Ghost	Fire
Lampent	Ghost	Fire
Chandelure	Ghost	Fire
Axew	Dragon	none
Fraxure	Dragon	none
Haxorus	Dragon	none
Cubchoo	Ice	none
Beartic	Ice	none
Cryogonal	Ice	none
Shelmet	Bug	none
Accelgor	Bug	none
Stunfisk	Ground	Electric
Mienfoo	Fighting	none
Mienshao	Fighting	none
Druddigon	Dragon	none
Golett	Ground	Ghost
Golurk	Ground	Ghost
Pawniard	Dark	Steel
Bisharp	Dark	Steel
Bouffalant	Normal
Rufflet	Normal	Flying
Braviary	Normal	Flying
Vullaby	Dark	Flying
Mandibuzz	Dark	Flying
Heatmor	Fire	none
Durant	Bug	Steel
Deino	Dark	Dragon
Zweilous	Dark	Dragon
Hydreigon	Dark	Dragon
Larvesta	Bug	Fire
Volcarona	Bug	Fire
Cobalion	Steel	Fighting
Terrakion	Rock	Fighting
Virizion	Grass	Fighting
Tornadus	Flying	none
Thundurus	Electric	Flying
Reshiram	Dragon	Fire
Zekrom	Dragon	Electric
Landorus	Ground	Flying
Kyurem	Dragon	Ice
Keldeo	Water	Fighting
Meloetta	Normal	Psychic
Genesect	Bug	Steel
Chespin	Grass	none
Quilladin	Grass	none
Chesnaught	Grass	Fighting
Fennekin	Fire	none
Braixen	Fire	none
Delphox	Fire	Psychic
Froakie	Water	none
Frogadier	Water	none
Greninja	Water	Dark
Bunnelby	Normal	none
Diggersby	Normal	Ground
Fletchling	Normal	Flying
Fletchinder	Fire	Flying
Talonflame	Fire	Flying
Scatterbug	Bug	none
Spewpa	Bug	none
Vivillon	Bug	Flying
Litleo	Fire	Normal
Pyroar	Fire	Normal
Flabébé	Fairy	none
Floette	Fairy	none
Florges	Fairy	none
Skiddo	Grass	none
Gogoat	Grass	none
Pancham	Fighting	none
Pangoro	Fighting	Dark
Furfrou	Normal	none
Espurr	Psychic	none
Meowstic	Psychic	none
Honedge	Steel	Ghost
Doublade	Steel	Ghost
Aegislash	Steel	Ghost
Spritzee	Fairy	none
Aromatisse	Fairy	none
Swirlix	Fairy	none
Slurpuff	Fairy	none
Inkay	Dark	Psychic
Malamar	Dark	Psychic
Binacle	Rock	Water
Barbaracle	Rock	Water
Skrelp	Poison	Water
Dragalge	Poison	Dragon
Clauncher	Water	none
Clawitzer	Water	none
Helioptile	Electric	Normal
Heliolisk	Electric	Normal
Tyrunt	Rock	Dragon
Tyrantrum	Rock	Dragon
Amaura	Rock	Ice
Aurorus	Rock	Ice
Sylveon	Fairy	none
Hawlucha	Fighting	Flying
Dedenne	Electric	Fairy
Carbink	Rock	Fairy
Goomy	Dragon	none
Sliggoo	Dragon	none
Goodra	Dragon	none
Klefki	Steel	Fairy
Phantump	Ghost	Grass
Trevenant	Ghost	Grass
Pumpkaboo	Ghost	Grass
Gourgeist	Ghost	Grass
Bergmite	Ice	none
Avalugg	Ice	none
Noibat	Flying	Dragon
Noivern	Flying	Dragon
Xerneas	Fairy	none
Yveltal	Dark	Flying
Zygarde	Dragon	Ground
Diancie	Rock	Fairy
Hoopa	Psychic	Ghost
Volcanion	Fire	Water